01 01 00 00 00 00 00 00 00 00 00 00 00 00 00 00 00 00 00 00 00 00 00 00 00 22 01 01 01 21 21 21 21 21 21 21 21 01 21 21 21 21 21 21 21 01 21 21 21 21 21 21 21 01 21 21 21 01 01 01 01 00 00 00 00 01 01 01 01 01 01 01 01 01 01 01 01 01 01 01 01 01 01 01 01 01 01 01 01 01 01 01 01 01 01 01 01 01 01 01 01 01 01 01 01 01 01 01 01 01 01 01 01 01 01 01 01 01 01 01 01 01 01 01 01 01 01 01 01 01 01 01 01 01 01 01 01 01 01 01 01 01 01 01 01 01 01 01 01 01 01 01 01 01 00 00 00 00 00 00 00 00 01 01 
01 01 00 00 00 00 00 00 00 00 00 00 00 97 00 00 00 00 00 00 00 00 00 00 00 22 01 01 23 00 00 00 00 00 00 00 00 00 00 00 00 00 00 00 00 00 00 00 00 00 00 00 00 00 00 00 00 00 01 83 01 00 00 00 00 01 01 01 01 01 01 01 01 01 01 01 01 01 01 01 01 01 01 01 01 01 01 01 01 01 01 01 01 01 01 01 01 01 01 01 01 01 01 01 01 01 01 01 01 01 01 01 01 01 01 01 01 01 01 01 01 01 01 01 01 01 01 01 01 01 01 01 01 01 01 01 01 01 01 01 01 01 01 01 01 01 01 01 01 01 01 01 01 01 00 00 00 00 00 00 00 00 01 01 
01 01 00 00 00 00 00 00 00 00 00 00 00 01 01 00 00 00 00 00 00 00 00 00 00 22 01 01 23 00 00 00 00 00 00 00 00 91 00 00 00 00 00 00 00 91 00 00 00 00 00 00 00 91 00 00 00 00 00 00 00 00 00 00 00 01 21 21 21 21 01 01 21 21 21 21 21 21 21 01 01 01 21 21 21 21 01 01 01 21 21 21 21 21 21 01 01 01 21 21 21 21 21 21 01 01 01 01 01 01 21 21 21 21 21 01 01 01 21 21 21 01 01 01 01 01 01 01 01 01 01 01 01 01 01 01 01 01 01 01 01 01 01 01 01 01 01 01 01 01 01 01 01 01 00 00 00 58 59 58 59 00 01 01 
01 01 00 00 00 00 00 00 00 00 00 00 00 01 80 00 00 00 00 00 00 00 00 00 00 22 01 01 23 00 00 00 00 00 00 00 00 00 00 00 00 00 00 00 00 00 00 00 00 00 00 00 00 00 00 00 00 00 00 00 00 00 00 00 00 01 00 00 00 00 01 01 00 00 00 00 00 00 00 01 01 01 00 00 00 00 01 01 01 00 00 00 00 00 00 01 01 01 00 00 00 00 00 00 01 01 01 01 01 23 00 00 00 00 00 22 01 23 00 00 00 22 01 01 01 01 01 01 01 01 01 01 01 01 01 01 01 01 01 01 01 01 01 01 01 01 01 01 01 01 01 01 01 01 00 00 00 68 69 68 69 00 01 01 
01 01 00 00 00 00 00 00 00 00 00 00 00 01 01 00 00 00 00 00 00 00 00 00 00 22 01 01 23 00 00 00 00 00 00 00 00 00 00 00 00 00 00 00 00 00 00 00 00 00 00 00 00 00 00 00 00 00 00 00 00 00 00 01 01 01 00 00 00 00 00 00 00 00 00 00 00 00 00 00 00 00 00 00 00 00 00 00 00 00 00 00 00 00 00 00 00 00 00 00 00 00 00 00 00 00 00 22 01 23 00 00 00 00 00 22 01 23 00 00 00 22 01 01 01 01 01 01 01 01 01 01 01 01 01 01 01 01 01 01 01 01 01 01 01 01 01 01 01 01 01 01 01 01 00 58 59 00 00 00 00 00 01 01 
01 01 00 00 00 00 00 00 00 00 00 00 00 01 01 00 00 00 00 00 00 00 00 00 00 22 01 01 23 00 00 00 00 00 00 00 00 91 00 00 00 00 00 00 00 91 00 00 00 00 00 00 00 91 00 00 00 00 00 00 01 01 01 01 00 00 00 00 00 00 00 00 00 00 00 00 00 00 00 00 00 00 00 00 00 00 00 00 00 00 00 00 00 00 00 00 00 00 00 00 00 00 00 00 00 00 00 22 01 23 00 00 00 00 00 22 01 23 00 00 00 22 01 01 01 01 01 01 01 01 01 01 01 01 01 01 01 01 01 01 01 01 01 01 01 01 01 01 01 01 01 01 01 01 00 68 69 00 00 00 00 00 01 01 
01 01 00 00 00 00 00 00 00 00 01 01 00 01 01 00 01 01 00 00 00 00 00 00 00 22 01 01 23 00 00 00 00 00 00 00 00 00 00 00 00 00 00 00 00 00 00 00 00 00 00 00 00 00 00 00 00 00 00 00 00 00 00 00 00 00 00 00 00 00 00 00 00 00 00 00 00 00 00 00 00 00 00 00 00 00 00 00 00 00 00 00 00 00 00 00 00 00 00 00 00 00 00 00 00 00 00 22 01 23 00 00 00 00 00 22 01 23 00 00 00 22 01 01 01 01 01 01 01 83 01 01 83 01 01 83 01 01 01 01 01 01 01 01 01 01 01 01 01 01 01 01 01 01 00 58 59 58 59 00 00 00 01 01 
01 01 00 00 00 00 00 00 00 00 01 01 00 01 01 00 01 80 00 00 00 00 00 00 00 22 01 01 23 00 00 00 00 00 00 00 00 00 00 00 00 00 00 00 00 00 00 00 00 00 00 00 00 00 00 00 00 00 00 00 00 00 00 00 00 00 00 00 00 00 00 00 00 00 00 00 00 00 00 00 00 00 00 00 00 00 00 00 00 00 00 00 00 00 00 00 00 00 00 00 00 00 00 00 00 00 00 22 01 23 00 00 00 00 00 22 01 23 00 00 00 22 01 83 01 01 83 01 01 00 01 01 00 01 01 00 01 01 01 01 01 01 01 01 01 01 01 01 01 01 01 01 01 01 00 68 69 68 69 00 00 00 01 01 
01 01 00 00 00 00 00 00 00 00 01 01 00 01 01 00 01 01 00 00 00 00 00 00 00 22 01 01 23 00 00 00 00 01 01 00 00 91 00 00 01 01 01 00 00 91 00 00 01 01 01 00 00 91 00 00 01 01 01 00 00 00 97 00 00 00 00 00 00 00 00 00 00 00 00 00 00 00 00 00 00 00 00 00 00 00 00 00 00 00 00 00 00 00 00 00 00 00 00 00 00 00 00 00 00 00 00 01 01 01 00 00 00 00 00 01 01 01 00 00 00 01 01 00 01 01 00 01 01 00 00 00 00 00 00 00 00 00 00 01 01 01 01 01 01 01 01 01 01 01 01 01 01 01 00 58 59 00 00 00 00 00 01 01 
01 01 00 00 00 00 00 00 00 00 01 01 00 01 01 00 01 01 00 00 00 00 00 00 00 22 01 01 23 00 00 00 00 01 23 00 00 00 00 00 22 01 23 00 00 00 00 00 22 01 23 00 00 00 00 00 22 01 23 00 00 00 00 00 00 00 00 00 00 00 00 00 00 00 00 00 00 00 00 00 00 00 00 00 00 00 00 00 00 00 00 00 00 00 00 00 00 00 00 00 00 00 00 00 00 00 00 00 00 00 00 00 00 00 00 00 00 00 00 00 00 00 00 00 00 00 00 00 00 00 00 00 00 00 00 00 00 00 00 01 01 01 01 01 01 01 01 01 01 01 01 01 01 01 00 68 69 00 00 00 00 00 01 01 
01 01 00 00 00 00 00 01 01 00 01 01 00 01 01 00 01 01 00 01 01 00 00 00 00 22 01 01 23 00 00 00 00 01 23 00 00 00 00 00 22 01 23 00 00 00 00 00 22 01 23 00 00 00 00 00 22 01 23 00 01 01 01 01 00 00 00 00 00 00 00 00 00 00 00 00 00 00 00 00 00 00 00 00 00 00 00 00 00 00 00 00 00 00 00 00 00 00 00 00 00 00 00 00 00 97 00 00 00 00 00 00 00 00 00 00 91 00 00 00 00 00 00 00 00 00 00 00 00 91 00 91 00 91 00 91 00 91 00 01 01 01 01 01 01 01 01 01 01 01 01 01 01 01 00 58 59 00 00 00 00 00 01 01 
01 01 00 00 00 00 00 01 01 00 01 01 00 01 01 00 01 01 00 01 80 00 00 00 00 01 01 01 01 00 00 00 00 01 23 00 00 91 00 00 22 01 23 00 00 91 00 00 22 01 23 00 00 91 00 00 22 01 23 00 00 00 00 01 01 01 00 00 00 00 00 00 00 00 00 00 00 00 00 00 00 00 00 00 00 00 00 00 00 00 00 00 00 00 00 00 00 00 00 00 00 00 00 00 00 00 00 00 00 00 00 00 00 00 00 00 00 00 00 00 00 00 00 00 00 00 00 00 00 00 00 00 00 00 00 00 00 00 00 01 01 01 01 01 01 01 01 01 01 01 01 01 01 01 00 68 69 00 00 00 00 00 01 01 
01 01 00 00 00 00 00 01 01 00 01 01 00 01 01 00 01 01 00 01 01 00 00 00 00 00 00 00 00 00 00 00 00 01 23 00 00 00 00 00 22 01 23 00 00 00 00 00 22 01 23 00 00 00 00 00 22 01 23 00 00 00 00 00 00 01 00 00 00 00 24 24 24 00 00 00 00 00 00 01 01 01 00 00 00 00 24 24 24 00 00 00 00 00 00 24 24 24 00 00 00 00 00 00 01 01 01 00 00 00 00 00 01 01 00 00 00 00 00 01 01 01 01 00 01 01 00 01 01 00 90 00 90 00 90 00 90 66 67 01 01 01 01 01 01 01 01 01 01 01 01 01 01 01 00 00 00 00 00 00 00 00 01 01 
01 01 00 99 67 00 00 01 01 00 01 01 00 01 01 00 01 01 00 01 01 00 00 00 00 00 97 00 00 00 00 01 01 01 23 00 00 00 00 00 22 01 23 00 00 00 00 00 22 01 23 00 00 00 00 00 22 01 23 00 00 00 00 00 00 01 20 20 20 20 01 01 01 20 20 20 20 20 20 01 01 01 20 20 20 20 01 01 01 20 20 20 20 20 20 01 01 01 20 20 20 20 20 20 01 01 01 00 90 00 90 00 01 01 00 90 00 90 00 01 01 01 01 82 01 01 82 01 01 00 01 01 00 01 01 00 01 30 31 01 01 01 01 01 01 01 01 01 01 01 01 01 01 01 66 67 00 00 00 00 66 67 01 01 
01 01 01 16 17 01 82 01 01 82 01 01 82 01 01 82 01 01 82 01 01 82 01 01 01 01 01 01 01 01 01 01 01 01 01 20 20 01 20 20 01 01 01 20 20 01 20 20 01 01 01 20 20 01 20 20 01 01 01 82 01 00 00 00 00 01 01 01 01 01 01 01 01 01 01 01 01 01 01 01 01 01 01 01 01 01 01 01 01 01 01 01 01 01 01 01 01 01 01 01 01 01 01 01 01 01 01 01 01 01 01 01 01 01 01 01 01 01 01 01 01 01 01 01 01 01 01 01 01 82 01 01 82 01 01 82 01 01 01 01 01 01 01 01 01 01 01 01 01 01 01 01 01 01 30 31 01 01 01 01 30 31 01 01
01 01 01 01 01 01 01 01 01 01 01 01 01 01 01 01 01 01 01 01 01 01 01 01 01 01 01 01 01 01 01 01 01 01 01 01 01 01 01 01 01 01 01 01 01 01 01 01 01 01 01 01 01 01 01 01 01 01 01 01 01 00 00 00 00 01 01 01 01 01 01 01 01 01 01 01 01 01 01 01 01 01 01 01 01 01 01 01 01 01 01 01 01 01 01 01 01 01 01 01 01 01 01 01 01 01 01 01 01 01 01 01 01 01 01 01 01 01 01 01 01 01 01 01 01 01 01 01 01 01 01 01 01 01 01 01 01 01 01 01 01 01 01 01 01 01 01 01 01 01 01 01 01 01 01 01 01 01 01 01 01 01 01 01 