00 00 00 00 00 00 00 00 00 01 01 01 01 01 01 01 01 01 01 01 01 01 01 01 01 01 01 01 01 01 01 01 01 01 23 00 00 00 00 00 00 00 00 00 00 00 22 01 01 01 01 01 01 01 01 01 01 01 01 01 01 01 01 01 01 01 01 01 22 01 23 00 00 00 00 00 00 00 00 00 00 00 00 00 00 00 00 00 00 00 00 00 01 01 01 01 01 01 01 01 
00 92 00 00 00 00 00 00 00 01 01 01 01 01 01 01 01 01 01 01 01 01 01 01 00 00 00 00 00 00 00 00 01 01 23 00 00 00 00 00 00 97 00 00 00 00 22 01 01 01 01 01 01 01 01 01 01 01 01 01 01 01 01 01 01 01 01 01 22 01 23 00 00 00 00 00 00 00 00 00 00 00 00 00 00 00 00 00 00 00 00 00 01 01 01 01 01 01 01 01 
00 00 00 00 00 00 00 00 00 01 01 01 01 01 01 01 01 01 01 01 01 01 01 01 00 00 00 00 97 00 00 00 01 01 23 00 00 91 00 00 00 00 00 00 91 00 22 01 01 01 01 01 01 01 01 01 01 01 01 01 01 01 01 01 01 01 01 01 22 01 23 00 00 00 00 00 00 00 00 00 00 00 00 00 00 00 00 00 00 00 00 00 01 01 01 01 01 01 01 01 
00 00 00 00 00 00 00 00 00 01 01 01 01 01 01 01 01 01 01 01 01 01 01 01 00 00 00 00 00 00 00 00 01 01 23 00 00 00 00 00 01 01 01 00 00 00 22 01 01 01 01 01 01 01 01 01 01 01 01 01 01 01 01 01 01 01 01 01 01 01 23 00 00 00 00 00 00 00 00 00 00 00 00 00 00 00 00 00 00 00 00 00 01 01 01 01 01 01 01 01 
00 00 00 00 00 00 00 00 00 01 01 01 01 01 01 01 01 01 01 01 01 01 01 01 00 00 00 01 01 01 00 00 22 01 23 00 00 00 00 00 22 01 23 00 00 00 22 01 01 01 01 01 01 01 01 83 01 01 01 01 01 01 01 01 01 01 01 01 01 01 23 00 00 00 00 00 00 00 00 00 00 00 00 00 00 00 00 00 00 00 00 00 01 01 01 01 01 01 01 01 
00 00 00 00 00 00 00 00 00 01 01 01 01 01 01 01 01 01 01 01 01 01 01 01 00 00 00 00 01 23 00 00 22 01 23 00 00 00 00 00 22 01 23 00 00 00 22 01 01 01 01 01 01 01 00 00 00 00 00 00 00 00 00 00 00 00 00 00 22 01 23 00 00 00 00 00 00 00 00 00 00 00 00 00 00 00 00 00 00 00 00 00 01 01 01 01 01 01 01 01 
00 00 00 00 00 00 00 00 00 01 01 01 01 01 01 01 01 01 01 01 01 01 01 01 00 00 00 00 01 23 00 00 22 01 23 00 00 91 00 01 01 01 23 00 91 00 22 01 01 01 01 01 83 00 00 00 00 00 00 00 00 00 00 00 00 00 00 00 22 01 23 00 00 00 00 00 00 00 00 00 01 01 00 00 00 00 00 00 00 00 00 00 01 01 01 01 01 01 01 01 
00 00 00 00 00 00 00 00 00 01 01 01 01 01 01 01 01 01 01 01 01 01 01 01 01 00 00 00 01 23 00 00 22 01 23 00 00 00 00 00 22 01 23 00 00 00 22 01 01 01 01 01 00 00 00 00 00 00 00 00 00 00 00 00 00 00 00 00 22 01 23 00 00 00 00 00 00 00 00 00 00 00 00 00 00 00 00 00 00 00 00 00 01 01 01 01 01 01 01 01 
00 00 00 00 00 00 00 00 00 01 01 01 01 01 01 01 01 01 01 01 01 01 01 01 00 00 00 00 01 23 00 00 22 01 23 00 00 91 00 00 22 01 23 00 91 00 22 01 01 01 01 00 00 00 00 00 00 00 00 00 00 00 00 00 00 00 00 00 01 01 01 00 00 00 00 00 00 00 00 00 00 00 00 00 00 00 00 00 00 00 00 00 01 01 01 01 01 01 01 01 
00 00 00 00 00 00 00 00 00 01 01 01 01 01 01 01 01 01 01 01 01 01 01 01 00 00 00 00 01 23 00 00 22 01 23 00 00 00 00 00 22 01 23 00 00 00 22 01 01 83 00 00 00 00 00 00 00 00 00 00 00 00 00 00 00 00 00 00 00 94 00 00 00 00 00 00 00 00 00 00 00 00 00 00 00 00 00 00 00 96 00 00 00 94 00 00 00 00 01 01 
00 00 00 00 00 00 00 00 00 00 00 00 00 00 00 00 00 00 00 00 00 00 00 00 00 00 00 01 01 23 00 00 01 01 01 01 00 00 00 00 22 01 23 00 00 00 01 01 01 00 00 00 00 00 00 00 00 00 00 00 01 00 01 00 00 00 00 00 00 00 00 00 00 00 00 00 01 01 00 00 00 00 00 00 01 01 00 00 00 00 00 00 00 00 00 00 00 00 01 01 
00 00 00 00 00 00 00 00 00 00 00 00 00 00 00 00 00 00 00 00 00 00 00 00 00 00 00 00 01 23 00 00 00 00 00 00 00 00 00 00 22 01 23 00 00 00 00 00 00 00 00 00 00 00 00 00 00 00 00 01 01 00 01 01 00 00 00 00 00 00 00 00 00 00 00 00 00 00 00 00 00 00 00 00 00 00 00 00 00 00 00 00 00 00 00 00 00 00 01 01 
00 00 00 00 00 00 00 00 00 00 00 00 00 00 00 00 00 00 00 00 00 00 90 00 90 00 90 00 01 23 00 00 00 00 00 00 00 91 00 00 22 01 23 00 91 00 00 00 00 00 00 00 00 00 00 00 00 00 00 01 01 82 01 01 00 01 00 00 00 00 00 00 00 00 00 00 00 00 00 00 00 00 00 00 00 00 00 00 00 00 00 00 00 00 00 00 00 00 01 01 
00 00 00 00 00 00 99 67 00 00 00 00 90 00 90 00 90 00 90 00 01 01 01 01 01 01 01 01 01 23 00 00 00 00 00 00 00 00 00 00 22 01 23 00 00 00 00 00 00 00 00 00 00 00 00 00 00 01 00 01 01 00 01 01 00 01 01 00 00 00 00 00 00 00 00 00 00 00 00 00 00 00 00 00 00 00 00 00 00 00 00 00 00 00 00 00 66 67 01 01 
01 01 01 01 01 01 16 17 01 01 01 01 01 01 01 01 01 01 01 01 01 01 01 01 01 01 01 01 01 01 01 01 01 01 01 01 01 01 01 01 01 01 01 01 01 01 01 01 01 01 01 01 01 01 01 01 01 01 82 01 01 01 01 01 82 01 01 01 01 01 01 01 01 20 20 20 20 20 20 20 20 20 20 20 20 20 20 20 01 01 01 01 01 01 01 01 30 31 01 01
01 01 01 01 01 01 01 01 01 01 01 01 01 01 01 01 01 01 01 01 01 01 01 01 01 01 01 01 01 01 01 01 01 01 01 01 01 01 01 01 01 01 01 01 01 01 01 01 01 01 01 01 01 01 01 01 01 01 01 01 01 01 01 01 01 01 01 01 01 01 01 01 01 01 01 01 01 01 01 01 01 01 01 01 01 01 01 01 01 01 01 01 01 01 01 01 01 01 01 01